300000000333000000000000000000000000000000000000000000000000000000000000000000000000000000000000000333300000000003
300000000333000000000000000000000000000000000000000000000000000000000000000000000000000000000000000333300000000003
300000000333000000000000000000000000000000000000000000000000000000000000000000000000000000000000000333300000000003
30000000033300000000000000000000000000000000000000000d000f00000000000000000000000000000000000000000333300000000003
300000000333000000000000000001111111111111111f00001111111000000000000000000000000000000000000000000333300000000003
300000000333000000000000000003333333333333333000003333333000000000000d00000000000000000000000000000333300000000003
30000000000000000000000000011333333333333333300000333333300000000000000000000000000000000000000000f000000000000003
300000000000f00000000000000333333333333333333000000000000000000111110000000000000000000000000000000000000000000003
300000000111000000000000011333333333000000000000000000000000000333330000000000000000000000000000000111110000000003
30000s022333220000000000033333333333000d0000000000s000s000000003333322000000000000000000000f0000000333332200000003
3111111113331111111h1111133333333333111h1111111111111111111111133333111111111h11111111h1111111111113333311111111g3
333333333333333333333333333333333333333333333333333333333333333333333333333333333333333333333333333333333333333333
333333333333333333333333333333333333333333333333333333333333333333333333333333333333333333333333333333333333333333
333333333333333333333333333333333333333333333333333333333333333333333333333333333333333333333333333333333333333333

