3000000000000000000000000000000000000000000000000000000000000000000000000003
3000000000000000000000000000000000000000000000000000000000000000000000000003
30000000000000f00000000f000000f000000000000f00000000000000000000f00000000003
3111111h1111h1111h111h111h111h111h11111h111h1111h1111h1111111h11h111111111g3
3333333333333333333333333333333333333333333333333333333333333333333333333333
3333333333333333333333333333333333333333333333333333333333333333333333333333
3333333333333333333333333333333333333333333333333333333333333333333333333333
