100100000000000000000000000000000000000000000000000000000000000000000000000000000000000000000000000000000000000000000000000000000000000000000000000000000000000000000000000000000000000000000001
30030000000000000000000000000000000000000000000000000000000000000d000000d00000000000000000000000000000000000000000000000000000000000000000000000000000000000000000000000000000000000000000000003
30030000000000000000000000000000000000000000000000000000000000s00000000000000s000000000000000000000000000000000000000000000000000000000000000000000000000000000000000000000000000000000000000003
300300000000000000000000000000000000000000000000000000000000000ss0000000000ss0000000000000000000000000000000000000000000000000000000000000000000000000000000000000000000000000000000000000000003
30030000000000000000000000000000000000000000000000000000000000000ssssssssss000000000000000000000000000000000000000000000000000000000000000000000000000000000000000000000000000000000000000000003
30030000000000000000000000000000000000000000s000000000000000000000000000000000000000000000000000000000000000000000000000000000000000000000000000000000000000000000000000000000000000000000000003
300300000000000000000000000000000000000000000000000000000000000000000000000000000000000000000000000000000000000000000000000000000000000000000000000000000000000000000000000000000000000000000003
300300000000000000000000000000000000000000000000000d000000ddd000000000000000000000ddd00000000000000000000000000000000000000000000000011111111111111111113000000000000000000000000000000000000003
3003000000000000000000000000000s0011111100000001111111000011111111111111111111111111100000000000000000000000000000000000000000000000033333333333333333333000000000000000000000000000000000000003
3003000000000000000000000s0002000033333300000003333333000033333333333333333333333333300000f000000000000000000000000000000000000000000333333333333333333330000000000000000000000000000dddd0000003
300300000000000000000000111h11000000000000000000000000000000033333333333333333333300000000000000000000000000000s00000000000000000000d33333333333333333333000000000000000000000000000011110000003
300300000000000000000000333333000000000000000000000000000000003333333333333333333000000000000000000001111111100000111111100s000011h1133333333333333333333000000000000000000000000000033330000003
300300000000000000s00000000000000000000000000000000000000000000033333333333333330000000000000000000003333333300000333333300000003333333333333333333333333000000000000000000000000000000000000003
3000000001111h111111100000000000000000000000000f00000000000000000000000000000000000000000000000111111333333330000033333330000000000003333333333333333333300000000000000000000001h100000000000003
30000f0003333333333330000000000000000000000000000000000000f0000000000000000000000000000222000003333333333333322222333333300000000000033333333333333333333000000000000000000000033300000000000003
3111111113333333333330000000000000111111h11111111111h11111111111111111111111111111h111111111111333333333333333333333333331h111111100033333333333333333333000000000000000001111133311111111111g13
333333333333333333333000000000000033333333333333333333333333333333333333333333333333333333333333333333333333333333333333333333333300033333333333333333333000000001111111113333333333333333333333
333333333333333333333222222222222233333333333333333333333333333333333333333333333333333333333333333333333333333333333333333333333300033333333333333333333000000003333333333333333333333333333333
333333333333333333333333333333333333333333333333333333333333333333333333333333333333333333333333333333333333333333333333333333333300000000000000000000000000000333333333333333333333333333333333
333333333333333333333333333333333333333333333333333333333333333333333333333333333333333333333333333333333333333333333333333333333300000000000s00000000000000000333333333333333333333333333333333
333333333333333333333333333333333333333333333333333333333333333333333333333333333333333333333333333333333333333333333333333333333333333333333333333333333333333333333333333333333333333333333333
333333333333333333333333333333333333333333333333333333333333333333333333333333333333333333333333333333333333333333333333333333333333333333333333333333333333333333333333333333333333333333333333
333333333333333333333333333333333333333333333333333333333333333333333333333333333333333333333333333333333333333333333333333333333333333333333333333333333333333333333333333333333333333333333333
